[nivel1]
fuente = terrenogen.png
mapa = #.......................#
       #.$...................$.#
       #.$...................$.#
       #.$...................$.#
       #..............$$$$$$$$.#
       #.......................#
       ######.............######
			 #.......................#
			 #.$...................$.#
			 #.$...................$.#
			 #.$...................$.#
			 #..............$$$$$$$$.#
			 #.......................#
			 ######.............######
			 #.......................#
			 #.$...................$.#
			 #.$...................$.#
			 #.$...................$.#
			 #..............$$$$$$$$.#
			 #.......................#
			 ######.............######

[.]
tipo = cesped
x = 15
y = 0
col = 0

[$]
tipo = roca
x  = 17
y = 5
col = 1

[#]
tipo = agua
x  = 14
y = 0
col = 1
